NO ./textures/wall_north.xpm
SO ./textures/wall_south.xpm
WE ./textures/wall_west.xpm
EA ./textures/wall_east.xpm
F 48,166,2
C 28,142,199

11111111111111111
100000000000000001111111
10000000000000000000001
100000000000N000011111111111
10000000000000000100000000001
10000001000000000000001111101
1000000000000000011111111111
100000000000000001
100000000000000001
100000000000000001
111111111111111111